0000400000
03000^0000
0000000020
0000000000
0100000000